x25555555555555555555125555555555555555555551x
x79888888888888888888778888888888888888888897x
x78255182555518255518778255518255518255555187x
x78455384555538455538438455538455538455555387x
x78888888888888888888888888888888888888888887x
x78255182185582551825555518255555551825555187x
x78455387788887xx787xxxxx78455555553845555387x
x78888887455187xx787xxxxx78888888888888888887x
x45555187255384553845555538255555551825555553x
xxxxxx78778888888888888888845555551787xxxxxxxx
xxxxxx78778255551825566551888888887787xxxxxxxx
555555384387xxxx787xxxxxx782555518438455555555
0000000888845555384555555384555538888000000000
5555551821888888888888888888888888218255555555
xxxxxx78778255555555555555555555187787xxxxxxxx
xxxxxx787787xxxxxxxxxxxxxxxxxxxx787787xxxxxxxx
x25555384384555555555125555555553843845555551x
x78888888888888888888778888888888888888888887x
x78255182555551825518778255182555551825555187x
x78455384555553845538438455384555553845555387x
x79888888888888888888888888888888888888888897x
x45555555555555555555555555555555555555555553x
xxxxxxxxxxxxxxxxxxxxxxxxxxxxxxxxxxxxxxxxxxxxxx